12 10 200                     
2 2 2 2 2 2 0 2 2 5 2 3 0 2 2 2 2 2 3 2 3 2 2 2 2 2 2 2 0 2 2 2 2 3 2 2 2 2                                                                            
2 3 1 3 2 2 2 2 2 2 0 2 2 2 2 2 2 2 2 2 3 5 2 2 3 2 2 2 2 0 2 2 2 2 2 0 2 2                                                                             
2 2 2 2 2 2 2 2 2 2 0 2 2 0 2 2 2 2 2 3 2 3 2 2 3 2 2 2 2 2 2 2 2 3 2 2 2 2 
3 2 0 0 2 2 2 2 2 2 2 2 2 3 2 2 2 2 2 2 3 2 2 3 2 2 2 2 3 2 2 2 3 2 2 2 2 2                                                                            
3 2 3 3 2 2 2 2 2 2 2 2 2 3 3 2 2 3 2 2 2 2 2 2 2 2 2 2 2 2 2 2 2 3 2 3 0 2                                                                             
2 2 2 3 2 2 3 2 2 2 2 2 2 2 2 3 2 2 2 2 2 2 2 2 3 2 0 3 2 2 2 2 2 3 2 3 3 2                                                                             
4 4 4 4 4 4 4 4 4 4 4 4 4 4 4 4 4 4 4 4 4 4 4 4 4 4 4 4 4 4 2 2 2 3 2 2 3 2                                                                           
2 0 2 2 2 3 2 2 5 2 0 2 2 3 2 3 2 2 2 2 2 2 2 2 2 2 5 2 3 0 2 2 2 2 2 2 3 2                                                                               
2 2 5 2 2 2 2 2 3 2 2 2 2 2 0 2 2 2 2 2 2 2 2 3 0 0 3 2 2 5 2 2 2 2 3 2 2 2                                                                              
2 2 2 3 2 2 3 2 3 2 2 2 2 2 2 2 2 2 2 2 2 2 2 3 3 2 3 2 2 3 2 2 2 2 2 2 2 2                                                                              
2 0 2 2 2 2 2 3 2 2 2 2 2 2 2 2 3 3 0 2 2 2 2 2 2 2 3 2 2 3 2 5 2 2 2 2 0 2                                                                              
2 3 2 2 0 2 2 3 2 0 0 2 2 2 2 2 3 2 3 5 2 2 5 2 2 2 2 3 2 2 2 3 2 2 5 2 3 2                                                                              
2 5 3 2 2 2 2 2 2 2 2 2 2 2 2 2 2 3 3 3 2 2 3 2 2 2 2 2 2 2 2 5 2 2 2 2 2 3                                                                              
2 2 2 2 2 2 2 2 4 4 4 4 4 4 4 4 4 4 4 4 4 4 4 4 4 4 4 4 4 4 4 4 4 4 4 4 4 4                                                                              
0 0 2 2 2 2 2 2 2 2 2 0 2 2 2 5 2 2 2 2 3 2 2 2 2 2 3 2 2 2 3 2 2 2 2 2 2 2                                                                              
3 0 2 2 2 2 2 2 2 2 2 3 3 2 2 3 2 2 2 2 2 2 2 2 3 2 2 2 2 2 2 3 2 3 0 2 2 6                                                                              
2 3 2 2 3 2 2 2 2 2 2 2 2 3 2 2 2 2 2 3 2 0 0 2 2 2 2 5 2 2 2 3 2 3 3 2 2 2                                                                             
2 2 2 2 3 5 2 2 0 2 2 2 2 2 2 2 2 3 2 2 2 2 2 2 3 2 3 5 2 2 2 2 2 2 3 2 2 2                                                                             
2 2 2 0 2 2 0 2 3 2 2 3 2 3 3 2 2 2 2 2 2 2 2 2 3 2 3 5 2 2 2 2 2 2 3 2 2 3                                                                              
2 5 2 2 2 2 3 2 2 2 2 2 0 2 2 2 2 2 2 2 2 2 0 2 3 2 2 3 2 2 2 2 3 2 2 2 3 2                                                                              
                                       