10 20 140
2 3 2 2 3 2 2 4 2 3 2 2 2 5 2 4 2 2 2 3 2 3 2 4 0 2 2 2 2 2 2 4 2 2 3 3 2 2
2 2 2 2 2 2 2 4 2 2 2 2 2 2 0 4 0 0 2 0 2 2 2 4 3 2 2 5 2 2 2 4 2 2 2 2 3 2
0 0 0 0 0 0 0 0 0 0 0 0 0 0 3 0 3 3 0 0 0 0 0 0 0 0 0 0 0 0 0 0 0 0 0 0 0 0
5 2 2 2 2 2 2 4 2 3 2 2 2 2 3 4 2 3 2 0 2 2 0 4 2 2 3 2 2 5 2 4 2 2 3 2 3 2
2 2 2 2 2 2 2 4 2 3 2 2 2 2 3 4 2 3 2 0 0 2 2 4 2 2 2 2 2 3 2 4 2 2 2 0 2 2
4 4 4 4 4 4 4 4 4 4 4 4 4 4 4 4 4 4 4 0 4 4 4 4 4 4 4 4 4 4 4 4 4 4 4 4 4 4
2 2 2 2 3 3 2 4 2 2 0 2 2 2 2 4 2 2 2 0 2 2 3 4 2 2 2 2 0 2 2 4 2 2 2 2 2 0
2 2 2 2 2 2 2 4 2 2 3 2 2 2 2 4 2 2 2 0 2 2 2 4 2 2 2 2 3 2 0 4 2 2 2 2 2 3
0 0 0 0 0 0 0 0 0 0 0 0 0 0 0 0 0 0 0 0 0 0 0 0 0 0 0 0 3 0 0 0 0 0 0 0 0 3
3 2 2 3 2 2 2 4 2 2 2 2 3 2 2 4 2 2 3 0 2 2 2 4 2 2 2 2 2 2 5 4 0 2 2 2 2 2
3 2 2 2 2 3 2 4 2 2 3 2 2 3 2 4 2 2 2 0 2 0 0 4 2 2 2 2 2 2 2 4 3 2 2 2 3 2
2 3 2 2 2 2 2 4 2 2 2 3 2 2 2 4 2 2 2 0 2 3 3 4 2 2 2 2 2 2 2 4 3 3 2 2 5 2
4 4 4 4 4 4 4 4 4 4 4 4 4 4 4 4 4 4 4 0 4 4 4 4 4 4 4 4 4 4 4 4 4 4 4 4 4 4
3 2 5 0 0 2 2 4 2 2 2 2 3 2 3 4 2 2 2 0 2 2 2 4 2 3 5 2 2 3 2 4 2 2 2 2 2 2
2 2 2 2 2 0 2 4 0 2 2 2 2 2 2 4 2 2 0 0 2 2 2 4 0 2 2 0 2 2 2 4 2 0 2 0 0 2
0 0 0 0 0 0 0 0 0 0 0 0 0 0 0 0 0 0 5 0 0 0 0 0 0 0 0 3 0 0 0 0 0 3 0 3 3 0
5 2 2 0 2 3 2 4 3 2 2 2 2 3 2 4 2 3 2 0 2 2 3 4 2 3 2 3 2 2 2 4 2 2 2 2 2 2
2 2 2 2 2 3 2 4 3 2 2 5 2 2 2 4 2 2 2 0 0 2 2 4 2 2 3 2 2 2 2 4 2 2 2 0 0 0
2 5 2 2 2 3 0 4 2 2 0 2 2 2 2 4 2 1 5 3 3 2 2 4 2 0 2 2 2 2 2 4 2 2 2 3 3 3
2 3 2 2 2 2 3 4 2 2 3 2 2 3 2 4 2 6 2 3 2 2 2 4 2 2 2 2 3 2 3 4 2 2 2 2 3 2