10 4 140
5 5 5 3 3 5 5 3 5 5 3 2 3 3 3 3 5 3 5 5 2 5 5 2 5 5 3 5 5 5 5 3 3 5 3 5 3 3
5 2 2 5 5 5 3 3 3 5 3 5 5 3 3 3 3 3 3 5 3 3 5 2 5 3 3 3 3 3 3 5 3 5 5 3 3 5
5 5 2 3 3 3 3 3 3 5 3 5 5 3 3 2 3 3 3 5 3 3 5 5 5 3 5 3 2 3 3 5 3 3 3 5 5 3 
2 2 5 3 5 5 3 3 3 3 3 3 5 3 3 5 5 5 2 2 5 5 3 3 5 3 5 5 5 3 3 3 5 3 5 5 5 3  
2 2 5 2 5 5 3 3 3 3 3 3 5 3 3 5 5 5 3 3 5 3 5 3 5 3 5 3 2 5 3 5 5 3 3 5 3 5 
5 5 5 2 2 5 3 5 2 5 5 3 3 5 5 3 3 5 5 5 3 3 5 3 5 3 3 3 2 5 3 5 5 3 3 5 3 5 
2 2 2 2 2 5 3 3 5 5 5 5 2 2 3 3 3 5 3 5 5 2 3 5 3 5 5 3 2 3 3 5 5 5 5 5 5 3
5 2 5 5 4 4 4 4 4 4 4 2 4 4 4 4 4 5 3 3 3 3 5 3 4 4 4 4 4 4 2 4 4 4 4 4 4 3
5 2 5 5 4 0 0 0 0 0 0 0 0 0 0 0 4 3 5 5 3 3 3 5 4 0 0 0 0 0 0 0 0 0 0 0 4 3
5 2 5 2 4 0 1 6 0 0 0 0 0 0 0 0 4 3 5 5 3 3 3 5 4 0 0 0 0 0 0 0 0 0 0 0 4 3
5 2 2 5 4 0 0 0 0 0 0 0 0 0 0 0 4 3 2 3 3 5 5 3 4 0 0 0 0 0 0 0 0 0 0 0 4 3
5 2 2 5 4 0 0 0 0 0 0 0 0 0 0 0 4 5 5 5 5 3 5 3 4 0 0 0 0 0 0 0 0 0 0 0 4 3
2 5 5 5 4 0 0 0 0 0 0 0 0 0 0 0 4 5 3 3 5 2 5 3 4 0 0 0 0 0 0 0 0 0 0 0 4 3
2 2 2 3 4 0 0 0 0 0 0 0 0 0 0 0 4 5 3 3 5 5 3 3 4 0 0 0 0 0 0 0 0 0 0 0 4 5
5 2 5 5 4 0 0 0 0 0 0 0 0 0 0 0 4 2 3 5 3 3 5 3 4 0 0 0 0 0 0 0 0 0 0 0 4 5
5 2 5 5 4 0 0 0 0 0 0 0 0 0 0 0 4 4 4 4 4 4 4 4 4 0 0 0 0 0 0 0 0 0 0 0 4 3
2 3 2 5 4 0 0 0 0 0 0 0 0 0 0 0 0 0 0 0 0 0 0 0 0 0 0 0 0 0 0 0 0 0 0 0 4 3
2 2 2 5 4 0 0 0 0 0 0 0 0 0 0 0 4 5 5 2 3 5 3 5 4 0 0 0 0 0 0 0 0 0 0 0 4 3
5 5 2 3 4 0 0 0 0 0 0 0 0 0 0 0 4 3 3 3 5 3 5 5 4 0 0 0 0 0 0 0 0 0 0 0 4 3
5 5 2 2 4 4 4 4 4 4 4 4 4 4 4 4 4 5 3 3 3 5 5 5 4 4 4 4 4 4 4 4 4 4 4 4 4 5
